111111111111111111111111111111111111111111111111111111111111111111111111111111111111111111111111111111111111111111111111
111111111111111100010111111111111111111111111111111111111111111111111111111111111111111111111111111111111111111111111111
111111111111111000000011001111111111111111111111111111111111111111111101111111111111111111111111111111111111111111111111
111111111111111000000010001111111111111111111111111111111111111111100000101111111111111111111111111111111111111111111111
111111111111110000000000000111111111111111111111111111111111111110000000011111111111111111111111111111111111111111111111
111111111111111000000000010111111111111111111111111111111111100110000000001010111111111111111111111111111111111111111111
111111111111111000000000011111111111111111111111111111111111000010000000011101111111111111111111111111111111111111111111
111111111111111000000000001111111111111111111111111111111110000011000000001000001100010011111111111111111111111111111111
111111111111111100000000011111111111111111111111111111111100000000000000000000000000000011111111111111111111111111111111
111110110111111100000000001111111111011111111111111111111000000000010000010000000000000011111111111111111111111111111111
111111000111111000000000000111111111000011111100111111111110000000011110001100000000000111111111111111111111111111111111
111001000111101000000010011111111100000010011001111111111110000000001110011000000000000101011111111111111111111111111111
111100000000000000000011111111111000000000000000111111111000000000001111111000000000000000011111111111111111111111111111
111000000000000000000111111111111000000000000011111111111110000000101011111000000000000000001111111101011111111111111111
111000000000000000000111111111111111000000000011111111111110000001110011111100000000000000011111111000011111111111111111
111000000000000000000100101111101010000000000111111111111110000001000011111100000000000000001111110000001111111111111111
110000000000000000000000011110000000000000000011111111111111000000000001111000000000000000011111000000011111111111111111
110000000000000000000000000000000000000000000011111111111111000000000010111100000000000000011110000001001111111111111111
111000000000000000000000000000000000000000000111111111111111100000000111111001100000000000111000000001111111111111111111
111000000000000000000000000000000000000000000111111111111111101000000111111000111000000000111000000000111111111111111111
110000000000000000000000000000000000000000000011111111111111111000000000111111111111000000001000000000111111111111111111
100000100000111000000000000000000000000000000111111111100111111100000000111111111111000000011100001000101111110111111111
110001110011111000000000000000000000000000000111111111100111111100000001111111111111000000111111011100001111110001111111
111011110111111000000000000000000000000000000101111111100001111000000101111111111111100011111110111100000010000001111111
111111111111111000000000000000000000000000000000111110000000000000000011111111111111111111111111111111000000000001111111
111111111111111111000000000000111001000001110100110111000000000000000111111111111111111111111111111111100000000001111111
111111111111110110000000000001111111111111111100000010000000000000000011111111111111111111111111111111100000000001111111
111111111111110111101010100001111111111111111100000010000000000000000101111111111111111111111111111111110000000001111111
111111111111111111111111111111111111111111111000000000000000000000000000111111111111111111111111111111100000000001111111
111111111111111111111110111011111111111111111100000000000000000000000000111111111111111111110111111111110000000001001111
111111111111111111111110001000111111111111111100000000000000000000000111111111111111111111100111111111000000000000011111
111111111111111111111111001000001111111111111100000000000000000000000111111111111111111111110010010010000000000001111111
111111111111111111111111000000000111111111111100000000000000000000000111111111111111111111110000000000000000000001111111
111111111111111111111111000000000010111111111000000000000000000001100111111111111111111111100000000000000000000011111111
111111111111111111111111000000000000111111111000000000000000000000111101111111111111111111000000000000000000000011111111
111111111111111111111110000000000000011111111100000000000000000000011101111111111111111111100000000000000000000111111111
111111111111111111111111000000000000011111111111000000000000000000001111111111111111111111100000000000000000000011111111
111111111111111111111110000001100000011111111100000000000000000001011111111111111111111111100101010111000000000011111111
111111111111111111111111100111100000011111111100000000000000000001111111111111111111111111111111100110000000000011111111
111111111111111111111111101111100000001111111100001100000000000001011111111111111111111111111111110110000000000011111111
111111111111111111111111111111110000001111111111111100000000000000011111111111111111111111111111111110000000000111111111
111111111111111111111111111111100000011011110001111000000000000001111111111111111111111111111111111111000000000111111111
111111111111111111111111111111100000000011110000111100000000000000111111111111111111111111111111111111100000000011111111
111111111111111111111111111111000000000100000001011110010000000000111111111111111111111111111111111111100000000000001111
111111111111111111111111111110000000000000000000001111110000000000001111111111111111111111111111111111000000000000011111
111111111111111111111111111111000000000000000000001111000000000000101111111111111111111111111111111110000000000000011111
111111111111111111111111111111100000000000000000001111000000000001111111111111111111111111111111111110000000000000001111
111111111111111111111111111111110000000000000000000110010000000001111111111111111111111111111111111111100000000000001111
111111111111111111111111111111000000000000000000000111100000000001111111111111111111111111111111111111100000000001111111
111111111111111111111111111110011110001100011011001111110000000010101111111111111111111111111111111111100000000000111111
111111111111111111111111111110011110011100111111011111111100001110001111111111111111111111111111111110000000000000011111
111111111111111111111111111111111111111101111111011111111111001111011111111111111111111111111111111111000000000000011111
111111111111111111111111111111111111111111111111111111111111111111111111111111111111111111111111111111000000000000001111
111111111111111111111111111111111111111111111111111111111111111111111111111111111111111111111111111111000000100101101111
111111111111111111111111111111111111111111111111111111111111111111111111111111111111111111111111111111110001111100111111
111111111111111111111111111111111111111111111111111111111111111111111111111111111111111111111111111111110000111101111111
111111111111111111111111111111111111111111111111111111111111111111111111111111111111111111111111111111111111111111111111
111111111111111111111111111111111111111111111111111111111111111111111111111111111111111111111111111111111111111111111111
111111111111111111111111111111111111111111111111111111111111111111111111111111111111111111111111111111111111111111111111
111111111111111111111111111111111111111111111111111111111111111111111111111111111111111111111111111111111111111111111111
